16,16
XXXXXXXXXXXXXXXX
X--------------X
X--------------X
X--------------X
X--------------X
X--------------X
X--------------X
X----FFF-------X
X--------------X
X--------------X
X--------------X
X--------------X
X--------------X
X--------------X
X--------------X
XXXXXXXXXXXXXXXX
METADATA
nextMap: 1