16,16
XXXXXXXXXXXXXXXX
X--------------X
X--------------X
X--------------X
X--------------X
X--------------X
X--------------X
X---XFFFX------X
X---H---G------X
X---H---G------X
X---H---G------X
X---XJJJX------X
X--------------X
X--------------X
X--------------X
XXXXXXXXXXXXXXXX
METADATA
nextMap: 1