16,16
XXXXXXXXXXXXXXXX
X--------------X
X--------------X
X--------------X
X-----------C--X
X--------------X
X--------------X
X---XFFFX------X
X---HK--G------X
X---H---G------X
X---H---G------X
X---XJJJX------X
X--------------D
X--------------D
X--------------X
XXXXXXXXXXXXXXXX
METADATA
nextMap: 1
lives: 3