16,16
XXXXXXXXXXXXXXXX
X--------------X
X-S------------X
X--------------X
X-----------C--X
X---K----------X
X--------------X
X---XFFFX------X
X---H---G------X
X---H---G------X
X---H---G------X
X---XJJJX------X
X--------------O
X--------------P
X--------------X
XXXXXXXXXXXXXXXX
METADATA
nextMap: 1
lives: 3