16,16
XXZXXXZXXXZXXXZX
X-----------V--X
X-S------------X
X--------------X
X-----------C--X
X---K----------X
X--------------X
X---XFFFX------X
X---H---G------X
X---H---G------X
X---H---G------X
X---XJJJX------X
X--------------O
X-----TYUI-----P
X--------------X
XXXXXXXXXXXXXXXX
METADATA
nextMap: 1
lives: 3
link_items: [[[12, 1], [4, 8]], [[12, 1], [4, 9]]]