16,16
XXXXXXXXXXXXXXXX
X--------------X
X-S------------X
X--------------X
X--------------X
X--------------O
X--------------P
X--------------X
XXXXXXXXXXX----X
X--------------X
X--------------X
X----XXXXXXXXXXX
X--------------X
X---------K----X
X--------------X
XXXXXXXXXXXXXXXX
METADATA
nextMap: 2
lives: 3
