16,16
XXXXXXXXXXXXXXXX
X----C----G---XX
X-S--C--K-G---XX
X----C----G---XX
XXXXXXXXXXX---XX
XXXXXXX-------XX
XXXXXXX-----C-XX
XXXXXXX---XXXXXX
XXXXXXX---XXXXXX
XXXXXXXFFFXXXXXX
XXXXXXX---XXXXZX
XXXXXXX--------O
XXXXXXX--------P
XXXXXXXXXXXXXXZX
XXXXXXXXXXXXXXXX
XXXXXXXXXXXXXXXX
METADATA
nextMap: 4
lives: 3
