16,16
XXXXXXXXXXXXXXXX
X---XXXXXXXXXXXX
Z-S-ZXXXXXXXXXXX
X---XXXXXXXXXXXX
Z---ZXXXXXXXXXXX
X---XXXXXXXXXXXX
Z---ZXXXXXXXXXXX
X---XXXXXXXXXXXX
Z---ZXXXXXXXXXXX
X---XXXXXXXXXXZX
X----T------G--X
XU-----K----G--O
X---------Y-G--P
XXXXXXXXXXXXXXZX
XXXXXXXXXXXXXXXX
XXXXXXXXXXXXXXXX
METADATA
nextMap: 5
lives: 3
