16,16
XXZXXZXXZXXZXXXX
XXX---V-----IXXX
XXX---V-----IXXX
XXX---V------XXX
XXZ---XXXXX--ZXX
XXX---XXXXX--XXX
X-----XXXXZ--XXX
X-S---XXXXXK-XXX
X-----XXXXX--XXX
XXXXXXXXXXXFFXXX
XXXXXXXXXXZ----O
XXXXXXXXXXX----P
XXXXXXXXXXX----X
XXXXXXXXXXZC---X
XXXXXXXXXXXXXZXX
XXXXXXXXXXXXXXXX
METADATA
nextMap: 6
lives: 1
link_items: [[[6, 1], [11, 9]], [[6, 2], [12, 9]]]
