16,16
XXZXXZXXZXXZXXXX
X------------TXX
X-S-----------XX
X-------------XX
XXZXXZXXZXX---XX
XXXXXXXXXXXVVVXX
XXXXXXXXXXX---XX
XXXXXXXXXXX---XX
XXXXXXXXXXX---XX
XXXXXXXXXXX---XX
XXXXXXXXXXX---XX
XXXXXXXXXXX---XX
XXXXXXXXXXXVVVXX
XXXXXXXXXXXFFFXX
XXXXXXXXXXX---XX
XXXXXXXXXXXXOPXX
METADATA
nextMap: 6
lives: 3
link_items: [[[11, 5], [11, 13]]]
