16,16
----------------
----------------
CCC-CCC-C---C-CC
C---C-C-CC-CC-C-
C-C-CCC-C-C-C-CC
C-C-C-C-C---C-C-
CCC-C-C-C---C-CC
----------------
----------------
CCC-C--C-CC-CCCC
C-C-C--C-C--C--C
C-C-C--C-CC-CCCC
C-C-C--C-C--C-C-
CCC--CC--CC-C--C
----------------
----------------
METADATA
neCtMap: 9
lives: 12
desc: Great Job, Our hero is free!
floor_type: texture_wood_floor
