16,16
XXXXXXXXXXXXXTTX
X----XXX-------X
X-B--XXX-------X
X----XXX--XZX--X
XXX--XXU--ZXZ--X
XXXCCXXU--XXX--X
XXXFFXXX--XXX--Z
X---------XXC--O
X--S------XXC--P
X---------XXX--Z
XXX--XXXYXXXXXXX
XXZ--ZXXXXXXXXXX
XXX--XXXXXXXXXXX
XXU---------V-ZX
XXU---------V-ZX
XXXXXXXXXXXXXXXX
METADATA
nextMap: 8
lives: 2
link_items: [[[12, 13], [3, 6]], [[12, 13], [4, 6]]]
floor_type: texture_wood_floor
desc: I think you get the gist of it.
